__header__
x;39;107
P;36;49
E;91;49
__map__
xxxxxxxxxx
x        x
x  P     xxxxxxxxx
xxx              x
  x       E      x
  x              x
  xxxxxxxxx      x
          x      x
          x  z   x
          x      x
          xxxxxxxx
